2222222222
2211222222
2211122112
2211122122
2211111112
2211111112
2411111112
2111111012
2111211112
2222222222
